7
50
20
__________________________________________________
__________________________________________________
__________________________________________________
_p_____________________________________________G__
tBtttttttttttttttttttttttttttttttttttttttttttttBtt
tttttttttttttttttttttttttttttttttttttttttttttttttt
BBBBBBBBBBBBBBBBBBBBBBBBBBBBBBBBBBBBBBBBBBBBBBBBBB