10
100
30
____________________________________________________________________________________________________
____________________________________________________________________________________________________
____________________________________1__________________________________________________4____________
___________________________________BBBB______________________________________________BBB____________
__________________a_______________B______________________________________________B_________t__7_____
__________________B____________B___________________t_____________B______________B________BBBBBB_____
________p__________________B___________________BBBBBBB_________B___B___________B____________________
________B___B_____B______B___________________B_______________B______B________B______________________
___ttt_______tttt___tttt___________t____t_______________________t___________________________________
BBBBBBBBBBBBBBBBB___BBBB___BBBBBBBBBBBBBBBBBBBBBBBBBBBBBBBBBB__BBB_BBBBBBBBBBB___________BBBBBBBBBBB