9
100
30
____________________________________________________________________________________________________
__p______________________________________________________________________________t__________________
_BBBB_______________________________t_______________________________________B____B_____t____________
_______________________t____B_______B_B______B_______________c___________t_____________B____t_______
______BB__B_B_B_B_B___BBB________t_B_______B____B____________B______BB___B___B__c___B___t__BB_______
__________________________B______B_____tc_t_______BB______B_____B_______________BB______B_____5_____
___7______ttttttttt__B________________BBBBBB____________________________B______2______________B__t__
___B______BBBBBBBBB____________B_______________6_______B_B_B_B_________________B_______B_________B__
______________________________________________BBB___________________________________________________


