11
100
30
____________________________________________________________________________________________________
____________________________________________________________________________________________________
____________________________________________________________________________________________________
_______t_c__________________t______B_BB___________p__________________________________________7______
______BBBBB____B_____B_____BBBB__________________BBB_____B_________t______8_____B__________BBBBB____
_____________t_____B_____B______________BB_____B_____________t___BBBB_____B_______B_____B___________
____________BB_____________c________________B__________B____BB_______t_______B_______BB_____________
________BB_________________B__________________c______B_______________BB___B_____B_______B___________
_____B________________________________________B_B___B_______________________________________________
_3____________ttt_9_____B___B_________________________________________________________________t__1__
BBBB________BBBBBBBB_____________________________________________________________________BBBBBBBBBBB