15
40
60
-1 -1 -1 -1 -1 -1 -1 33 33 -1 -1 -1 -1 -1 33 -1 -1 33 -1 -1 -1 -1 -1 -1 -1 -1 -1 -1 -1 -1 -1 -1 -1 -1 -1 -1 -1 -1 -1 -1
-1 -1 -1 -1 -1 -1 -1 33 33 -1 -1 -1 -1 -1 33 -1 -1 33 -1 -1 -1 -1 -1 -1 -1 -1 -1 -1 -1 -1 -1 -1 -1 -1 -1 -1 -1 -1 -1 -1
-1 -1 00 -1 -1 -1 -1 33 33 -1 -1 -1 -1 -1 33 -1 -1 33 -1 -1 -1 -1 -1 -1 -1 -1 -1 -1 -1 -1 -1 -1 -1 -1 -1 -1 -1 -1 -1 -1
-1 32 32 32 -1 -1 -1 38 33 -1 -1 -1 -1 -1 38 -1 -1 33 -1 -1 -1 -1 -1 -1 -1 -1 -1 -1 32 -1 32 -1 -1 -1 32 -1 32 -1 -1 -1
-1 -1 -1 -1 -1 -1 -1 -1 38 -1 -1 -1 -1 -1 -1 -1 -1 38 -1 -1 -1 -1 -1 -1 -1 -1 -1 -1 -1 -1 -1 -1 -1 -1 -1 -1 -1 -1 -1 -1
-1 -1 -1 -1 -1 -1 -1 -1 -1 -1 -1 -1 -1 -1 -1 -1 -1 -1 -1 -1 -1 -1 -1 -1 -1 -1 -1 32 -1 -1 -1 32 -1 32 -1 32 -1 -1 -1 -1
-1 -1 -1 -1 -1 32 32 -1 -1 -1 -1 -1 -1 -1 -1 -1 -1 -1 -1 -1 32 32 -1 -1 -1 -1 -1 -1 -1 -1 -1 -1 -1 -1 -1 -1 -1 -1 -1 -1
-1 -1 -1 -1 -1 -1 -1 -1 -1 32 32 -1 -1 32 -1 32 -1 32 -1 -1 -1 -1 -1 32 32 -1 32 -1 32 -1 32 -1 -1 -1 32 -1 32 -1 -1 -1
-1 -1 -1 -1 -1 -1 -1 32 -1 -1 -1 -1 -1 33 -1 33 -1 33 -1 -1 -1 -1 -1 -1 -1 -1 -1 -1 -1 -1 -1 -1 -1 -1 -1 -1 -1 -1 -1 -1
-1 -1 -1 -1 -1 -1 -1 -1 -1 -1 -1 -1 -1 33 -1 33 -1 33 -1 -1 -1 -1 -1 -1 -1 -1 -1 32 -1 -1 -1 32 -1 32 -1 32 -1 -1 -1 -1
-1 -1 -1 -1 -1 -1 -1 -1 -1 -1 -1 -1 -1 33 -1 33 -1 33 -1 -1 -1 -1 -1 -1 -1 -1 -1 -1 -1 -1 -1 -1 -1 -1 -1 -1 -1 -1 -1 -1
-1 -1 -1 -1 -1 -1 -1 -1 -1 -1 -1 -1 -1 33 -1 33 -1 33 -1 -1 -1 -1 -1 -1 -1 -1 -1 -1 32 -1 32 -1 -1 -1 32 -1 32 -1 -1 -1
-1 -1 -1 -1 -1 -1 -1 -1 -1 -1 -1 -1 -1 33 -1 33 -1 33 -1 -1 -1 -1 -1 -1 -1 -1 -1 -1 -1 -1 -1 -1 -1 -1 -1 -1 -1 07 -1 -1
-1 -1 -1 -1 -1 -1 -1 -1 -1 -1 -1 -1 -1 33 -1 33 -1 33 -1 -1 -1 -1 -1 -1 -1 -1 -1 32 -1 -1 -1 32 -1 32 -1 -1 -1 32 -1 -1
-1 -1 -1 -1 -1 -1 -1 -1 -1 -1 -1 -1 -1 33 -1 33 -1 33 -1 -1 -1 -1 -1 -1 -1 -1 -1 -1 -1 -1 -1 -1 -1 -1 -1 -1 -1 -1 -1 -1
