17
50
40
BBBBBBBBBBBBBBBBBBBBBBBBBBBBBBBBBBBBBBBBBBBBBBBBBB
_8________________________________________________
BBBBBBBBBBBBBBBBBBBBBBBBBBBBBBBBBBBBBBBBBBBBBBBBB_
_____________c______________c_____________________
____B__B__B__B__B__B__B__B__B__B__B__B__B__B__B__B
_c____t__t__t__t__t_ct__t__t__t__t__t__t__t__t__t_
BB_BBBBBBBBBBBBBBBBBBBBBBBBBBBBBBBBBBBBBBBBBBBBBBB
__________________________________________________
__B_B____________B______B_______B_____B____B______
_c_t____tt__tt___t__ct__t__________t________t_t___
BBBBBBBBBBBBBBBBBBBBBBBBBBBBBBBBBBBBBBBBBBBBBBB_BB
________________c_________________________________
___________BB___B_________________B________BBBBB__
_____3___________t______________B___B____B________
_____BB________BBBB___________________B___________
________BB__________a_p_____BBB___________________
___________________BBBBBB_________________________
