23
100
40
_____________________________________________4______________________________________________________
__________1______________________________BBBBBBBBBB_________________________________________________
________BBBBB______________________BB___________________BBB___BB____a________BB_______2_____________
_____________________________B__BB_________________________________BBB_____B_____BBBBBBBBB__________
______________BBB__BB__B__BB______________________________________________B_________________________
_________5_______________________________________________________________B__________________________
____BBBBBBBBBB__________________BBB____________ct______________________B____________________________
___________________________BBB_____BB__BB_BB__BBB__BBBB__BBBBB______BB______________________________
___________________c___________________________________________B____________________________________
_______________BBBBBBBBB________________________p_____t_______B_____________________________________
___________________________B_____B___BBBBB_BBBBBBBBBBBB_BBBBBB_____BBB____t_________________________
______________________________B_________________________________________BBBB________________________
_________________t_____t___________t_________t___c_____________________________tt___________________
________________BBBBBBBBBBBBBBBBBBBBBB_____BBBBBBBBBBB_________t______________BBBBB_________________
____________________________________________________________BBBBB________BBB________________________
_________0____B_________________________________________B___________________BB______________________
______BBBBBB______________________________t__________B______________t_______________________________
_______________________________________BBBBB___________BBB____c___BBBBBB____________________3_______
_______________________________BBBB_____t___________________BBBBB________________________BBBBBBBB___
____________________________________BBBBBB_______6__________________________________________________
_______________________________________________BBBBBB___________________tt___9______________________
_____________________7______________________________________________BBBBBBBBBBBBBB__________________
_______________BBBBBBBBBBBBBBB______________________________________________________________________