9
100
40
____________________________________________________________________________________________________
____________________________________________________________________________________________________
_______________c_____t__8_______B____t______________________________________________________________
_______________B_____BBBBBBB__________BB__________________ttt_______________________________________
_________5______________________________B_______BBBBBBBBBBBBBBBB____________________________________
___________________________________________B______________________B_B__B____________________________
_____________________________________________B_______________________________________B____t_ttt_____
______t_____________________p__t_______t______t______t______t____B________BB____BB______B_BBBBBBB___
_____BB______BB____BBBB_____B__B___B___B___B__B__B___B__B___B__________________________t__________4_
_____________________________________________________________________________________BBB__________B_
__________B______BBBBB___________________BBBB____________________________BBB________________________
____________________________________________BB______________________________________________________
______________________________________________BB__________________________________BB________________
______6______________________________________________1________________________c______________t__t__9
___BBBBBBBBBBBBBBBBBBBBBBBBBBBBBBBBBBBBB___________BBBB______________________BBB________BB___B__B__B