7
50
20
__________________________________________________
__________________________________________________
__________________________________________________
_8_____________________________________________G__
tBBttttttttttttttttttttttttttttttttttttttttttttBtt
tttttttttttttttttttttttttttttttttttttttttttttttttt
BBBBBBBBBBBBBBBBBBBBBBBBBBBBBBBBBBBBBBBBBBBBBBBBBB