10
100
30
____________________________________________________________________________________________________
____________________________________________________________________________________________________
____________________________________________________________________________________________________
____t_a_t____________________________________________________________________________BBBBBB____7____
____BBBBB_t_t___________BBBB_______________________________1t_________________________________BB____
_________BBBBB___t___t_______B__________________________B__BB___________________BBBBBB______________
_________________BBBBB__________________________________________________BBBBB_______________________
______________BB_______________B__________________BBBBB__________BBBB_______________________________
___p________________________t______tt_____t______tt_c_________tt_____t____t__c_______t_______t__t___
BBBBBBBBBBBBB______________BBB_BBBBBBBBBBBBBBBBBBBBBBBBBBBBBBBBBBBBBBBBBBBBBB_____BBBBBB___BBBBBBBBB