9
100
30
____________________________________________________________________________________________________
_________________________________________________________________________________t__________________
_BBBB_______________________________t_______________________________________B____B_____t____________
_______________________t____B_______B_B______B_______________c___________t_____________B___5________
______BB__B_B_B_B_B___BBB________t_B_______B____B____________B______BB___B___B__c___B___t__BB_______
__________________________B______B_____tc_t_______BB______B_____B_______________BB______B___________
__________ttttttttt__B________________BBBBBB____________________________B_____________________B__t__
___B______BBBBBBBBB____________B_______________7_______B_B_B_B_________________B_______B_________B__
______________________________________________BBB___________________________________________________


