11
100
30
____________________________________________________________________________________________________
____________________________________________________________________________________________________
____________________________________________________________________________________________________
_________c__________________t______B_BB_____________________________________________________________
______BBBBB____B_____B_____BBBB__________________BBB_____B_________t____________B__________BBBBB____
_____________t_____B_____B______________BB_____B_____________t___BBBB_____B_______B_____B___________
____________BB_____________c________________B__________B____BB_______t_______B_______BB_____________
________BB_________________B__________________c______B_______________BB___B_____B_______B___________
_____B_______________________B________________B_B___B______________________________________B________
______________t___2__B__B___B____________________________________________________________________5__
BBBB________BBBBBBBB_____________________________________________________________________BBBBBBBBBBB