9
100
30
____________________________________________________________________________________________________
____________________________________________________________________________________________________
______________________________________  ____________________________________________________________
________________B____________B_______________________________B____B_____B___________________________
_______c___________B_____BB_____BB____BBBB_____BBB___B___BBB____B____B_____B___________B____B_______
_______B___B__ B_____B_____________B________BB______c_______________________8_t____B_____B__________
_________B____B_____________________________________B____B____B____B____B_B_B_B_B____B______________
_____3_____________tttttt_tttttttttt_tttttttttttttttttt_ttttt_________________________ttttt_________
BBBBBBBBBBBBBBBBBBBBBBBBBBBBBBBBBBBBBBBBBBBBBBBBBBBBBBBBBBBBBBBBBBBBBBBBBBBBBBBBBBBBBBBBBBBBBBBBBBBB