23
100
40
____________________________________________________________________________________________________
____________________________________________________________________________________________________
___________________________________BB___________________BBB___BB____a________BB_______9_____________
_____________________________B__BB_________________________________BBB_____B_____BBBBBBBBB__________
_________5_______________________________________________________________B__________________________
____BBBBBBBBBB__________________B______________ct______________________B____________________________
______________BBB__BB__B__BB__________________________________________B_____________________________
____________________________BB__B__BB__BB_BB__BBB__BBBB__BBBBB______BB______________________________
___________________c___________________________________________B____________________________________
_______________BBBBBBBBB______________________________t_______B_____________________________________
___________________________B_____B___BBBBB_BBBBBBBBBBBB_BBBBBB_____BBB____t_________________________
______________________________B_________________________________________BBBB________________________
_________________t_____t___________t_________t___c_____________________________tt___________________
________________BBBBBBBBBBBBBBBBBBBBBB_____BBBBBBBBBBB_________t______________BBBBB_________________
____________________________________________________________BBBBB________BBB________________________
______________B_________________________________________B___________________BB______________________
______BBBBBB______________________________t__________B______________t_______________________________
_______________________________________BBBBB___________BBB____c___BBBBBB____________________________
_______________________________BBBB_____t___________________BBBBB________________________BBBBBBBB___
____________________________________BBBBBB__________________________________________________________
_______________________________________________BBBBBB___________________tt__________________________
_____________________0______________________________________________BBBBBBBBBBBBBB__________________
_______________BBBBBBBBBBBBBBB______________________________________________________________________