9
100
40
____________________________________________________________________________________________________
____________________________________________________________________________________________________
_______________c_____t__7_______B____t______________________________________________________________
_______________B_____BBBBBB__B____B___BB___________c______ttt_______________________________________
________________________________________B_______BBBBBBBBBBBBBBBB____________________________________
___________________________________________B______________________B_B__B____________________________
_____________________________________________B_______________________________________B____t_ttt_____
______t________________________t_______t_____________t______t____B________BB____BB______B_BBBBBBB___
_____BB_______B____BBBB_____B__B___B___B______B__B___B__B___B__________________________t____________
_____________________c__________________________B____________________________________BBB__________B_
__________B_B_B__BBBBB___________________BBBB__B_________________________BBB________________________
_________B__________________________________BB______________________________________________________
________B_____________________________________BB__________________________________BB________________
______4_______________________________________________________________________c______________t__t___
___BBBBBBBBBBBBBBBBBBBBBBBBBBBBBBBBBBBBB___________BBBB______________________BBB________BB___B__B__B